SKE
677 8
45 0
24 27 29 32 33 40 41 43 44 55 57 59 61 66 73 78 84 85 86 90 101 106 107 121 124 126 140 143 150 151 153 177 195 253 260 357 358 359 361 362 367 371 374 375 388 

44 0
150 151 153 167 195 212 213 234 243 244 246 247 273 274 275 277 279 289 290 295 301 302 311 319 320 342 344 346 348 352 354 524 525 532 535 537 538 540 544 546 552 553 570 584 

15 0
101 107 140 143 150 151 167 177 212 213 330 421 428 429 430 

30 0
107 121 143 273 274 275 291 301 302 306 309 311 313 320 328 329 330 338 339 342 346 347 348 354 355 356 357 403 405 412 

41 0
177 212 213 244 260 289 290 342 344 544 546 548 551 553 556 557 563 564 566 567 569 570 572 573 575 582 583 584 592 607 616 617 621 629 631 634 653 667 670 674 675 

25 0
234 242 243 244 249 250 253 263 266 268 563 629 631 634 639 643 644 650 652 653 654 659 661 665 669 

27 0
27 367 374 375 377 379 386 388 394 403 405 412 415 416 418 421 422 424 428 429 430 432 433 434 435 444 455 

41 0
143 150 153 212 246 279 289 388 405 415 416 418 422 428 429 432 433 434 435 436 444 446 449 451 453 454 455 457 461 465 470 481 483 493 500 509 510 512 513 514 517 

